Common Actions (Everyday Verbs)
하다 (Hada) -> 해요 (Haeyo): To do / I do

가다 (Gada) -> 가요 (Gayo): To go / I go

오다 (Oda) -> 와요 (Wayo): To come / I come

보다 (Boda) -> 봐요 (Bwayo): To see / To look / I see

먹다 (Meokda) -> 먹어요 (Meogeoyo): To eat / I eat

마시다 (Masida) -> 마셔요 (Masyeoyo): To drink / I drink

자다 (Jada) -> 자요 (Jayo): To sleep / I sleep

일어나다 (Ireonada) -> 일어나요 (Ireonayo): To wake up / To get up / I wake up

사다 (Sada) -> 사요 (Sayo): To buy / I buy

팔다 (Palda) -> 팔아요 (Parayo): To sell / I sell

Communication & Thought
말하다 (Malhada) -> 말해요 (Malhaeyo): To speak / To talk / I speak

듣다 (Deudda) -> 들어요 (Deureoyo): To hear / To listen / I listen

읽다 (Ikda) -> 읽어요 (Ilgeoyo): To read / I read

쓰다 (Sseuda) -> 써요 (Sseoyo): To write / To use / I write

생각하다 (Saenggakhada) -> 생각해요 (Saenggakhaeyo): To think / I think

알다 (Alda) -> 알아요 (Arayo): To know / I know

모르다 (Moreuda) -> 몰라요 (Mollayo): To not know / I don't know

배우다 (Baeuda) -> 배워요 (Baewoyo): To learn / I learn

묻다 (Mutda) -> 물어봐요 (Mureobwayo): To ask / I ask

대답하다 (Daedaphada) -> 대답해요 (Daedaphaeyo): To answer / I answer

Existence, Status & Feeling
있다 (Itda) -> 있어요 (Isseoyo): To be / To have / There is (Exist)

없다 (Eopda) -> 없어요 (Eopseoyo): To not be / To not have / There is not (Not Exist)

되다 (Doeda) -> 돼요 (Dwaeyo): To become / It becomes

싶다 (Sipda) -> 싶어요 (Sipeoyo): To want to / I want to

좋다 (Jota) -> 좋아요 (Joayo): To be good / I like it (It is good)

싫다 (Silta) -> 싫어요 (Sireoyo): To be disliked / I don't like it

슬프다 (Seulpeuda) -> 슬퍼요 (Seulpeoyo): To be sad / I am sad

기쁘다 (Gippeuda) -> 기뻐요 (Gippeoyo): To be happy / I am happy

바쁘다 (Bappeuda) -> 바빠요 (Bappayo): To be busy / I am busy

힘들다 (Himdeulda) -> 힘들어요 (Himdeureoyo): To be hard / It is difficult

Relationship & Giving
주다 (Juda) -> 줘요 (Jwoyo): To give / I give

받다 (Batda) -> 받아요 (Badayo): To receive / I receive

만나다 (Mannada) -> 만나요 (Mannayo): To meet / I meet

도와주다 (Dowajuda) -> 도와줘요 (Dowajwoyo): To help / I help

기다리다 (Gidarida) -> 기다려요 (Gidaryeoyo): To wait / I wait

같이 하다 (Gachi hada) -> 같이 해요 (Gachi haeyo): To do together / I do together

연락하다 (Yeollakhada) -> 연락해요 (Yeollakhaeyo): To contact / I contact

약속하다 (Yaksokhada) -> 약속해요 (Yaksokhaeyo): To promise / I promise

걸리다 (Geollida) -> 걸려요 (Geollyeoyo): To take (time) / It takes

사랑하다 (Saranghada) -> 사랑해요 (Saranghaeyo): To love / I love

Movement & Position
앉다 (Antda) -> 앉아요 (Anjayo): To sit / I sit

서다 (Seoda) -> 서요 (Seoyo): To stand / I stand

걷다 (Geotda) -> 걸어요 (Georeoyo): To walk / I walk

운전하다 (Unjeonhada) -> 운전해요 (Unjeonhaeyo): To drive / I drive

넣다 (Neota) -> 넣어요 (Neoheoyo): To put in / I put in

나오다 (Naoda) -> 나와요 (Nawayo): To come out / It comes out

들어가다 (Deureogada) -> 들어가요 (Deureogayo): To enter / To go in / I go in

끝내다 (Kkeunnaeda) -> 끝내요 (Kkeunnaeyo): To finish / I finish

시작하다 (Sijakhada) -> 시작해요 (Sijakhaeyo): To start / I start

보내다 (Bonaeda) -> 보내요 (Bonaeyo): To send / I send